WWWWWWWWWWWW
WEWGGGGGGWEW
WWWGGGGGGWWW
WEWGGGGGGWEW
WWWGGGGGGWWW
WWWGGGGGGWWW
WWWGGGGGGWWW
WWWGGGGGGWWW
WEWGGGGGGWEW
WWWGGGGGGWWW
WEWGGGGGGWEW
WWWWWWWWWWWW
---P--------