WWWWWWWWWWWW
WP------E--W
W------G---W
W----E-----W
W----------W
W-----E----W
W----------W
W--E-------W
W----------W
WE---------W
W---------EW
WWWWWWWWWWWW