WWWWWWWWWWWW
WPW--------W
WGWGWWWW-E-W
W-WWW--W---W
W----E-W---W
W-WW---W-E-W
W-WG---W---W
W-W----WWW-W
W--E--WW---W
W--WW-W---EW
W--GW---WG-W
WWWWWWWWWWWW