WWWWWWWWWWWW
WP---------W
W----------W
W----E-----W
W----------W
W----------W
W----------W
W----------W
W----------W
W----------W
W---------EW
WWWWWWWWWWWW