WWWWWWWWWWWW
WPW--------W
WGWGWWWW-E-W
WTWWW--W---W
W----E-W---W
W-WW---W-E-W
W-WG---W---W
W-W----WWWTW
W--E--WW---W
W--WWTW---EW
W--GW---WG-W
WWWWWWWWWWWW