WWWWWWWWWWWW
WP--------GW
WWW-WWWW-WWW
W--E----E--W
WWW-WWWW-WWW
W--E----E--W
WWW-WWWW-WWW
WG--------GW
W---WWWW---W
W--E-WW-E--W
WG---WW---GW
WWWWWWWWWWWW