WWWWWWWWWWWW
WPW--EE---GW
W---E--E---W
W--E-GG-E--W
W---E--E---W
W----EE----W
W---E--E---W
W--E-GG-E--W
W---E--E---W
W----EE----W
WG--------GW
WWWWWWWWWWWW