WWWWWWWWWWWW
WP--------GW
WWWTWWWWTWWW
W--E----E--W
WWWTWWWWTWWW
W--E----E--W
WWWTWWWWTWWW
WG--------GW
W---WWWW---W
W--E-WW-E--W
WG---WW---GW
WWWWWWWWWWWW