WWWWWWWWWWWW
WPW------WWW
W-W-WWWW--WW
W-WWW--WW--W
W----E-W--WW
W-WW---W-WWW
W-W----W---W
W-W----WWW-W
W--E--WW---W
W--WW-W---EW
W---W---W--W
WWWWWWWWWWWW