WWWWWWWWWWWW
W---------EW
WPWWTWWWWW-W
WWW-E----W-W
WG---W-W-W-W
W-E--W-WGW-W
W---GW-WWW-W
WTWWWW-W---W
WE----ET---W
W-WWWW-W---W
W---G--WG-EW
WWWWWWWWWWWW