WWWWWWWWWWWW
WE--------EW
WGWWW--WWW-W
W-WP----GW-W
W-W-T--T-W-W
W----EE----W
W----EE----W
W-W-T--T-W-W
W-WG----GW-W
W-WWW--WWWGW
WE--------EW
WWWWWWWWWWWW