------------
--WW--W---W-
-W--W-W---W-
-W--W--W-W--
--WW----W---
------------
-WWW--WWW---
-W----W--W--
-WWW--WWW---
-W----W--W--
-WWW--W--W--
------------
---P--------