WWWWWWWWWWWW
WPW-TEE---GW
W--TE--ET--W
WT-E-GG-E--W
W---E--E---W
W--T-EE-T--W
WT--E--E---W
W--E-GG-E-TW
W--TE--ET--W
W----EE----W
WG---T----GW
WWWWWWWWWWWW