WWWWWWWWWWWW
W---------EW
WPWW-WWWWW-W
WWW-E----W-W
WG---W-W-W-W
W-E--W-WGW-W
W---GW-WWW-W
W-WWWW-W---W
WE----E----W
W-WWWW-W---W
W---G--WG-EW
WWWWWWWWWWWW