WWWWWWWWWWWW
WPW------WWW
W-W-WWWW--WW
W-WWWE-WW--W
W------W--WW
W-WW---W-WWW
W-W----W---W
W-W----WWW-W
W-----WW---W
W--WW-W----W
W---W---W-EW
WWWWWWWWWWWW